##        ##########
## ######B      ####
## ###### ##### ####
##      # #     #  #
#  #### # #### ## ##
######  # ###     ##
##     ## #   ######
## ###### # ###### #
##   ####   ####   #
####   ## ####   ###
###### ##      #####
###    ## ##########
###### ##       ####
#      ########   ##
# ######   #### # ##
#  #######  ### #  #
##  #######     ## #
###    ##   ###  ###
######    ######   #
##################A#